{
	"tileset" : "chemin.png",
	"field" : [
		[2, 2, 2, 2, 2, 2, 9, 10, 11,  2,  2,  2,  2,  2,  2,     2,  2,  2,  2,  2,  2, 9, 10, 11,  2,  2,  2,  2,  2,  2],
		[2, 2, 2, 2, 2, 2, 9, 10, 11,  2,  2,  2,  2,  2,  2,     2,  2,  2,  2,  2,  2, 9, 10, 11,  2,  2,  2,  2,  2,  2],
		[2, 2, 2, 2, 2, 2, 9, 10, 11,  2,  2,  2,  2,  2,  2,     2,  2,  2,  2,  2,  2, 9, 10, 11,  2,  2,  2,  2,  2,  2],
		[2, 2, 2, 2, 2, 2, 9, 10,  8,  6,  6,  6,  6,  6,  6,     6,  6,  6,  6,  6,  6, 8, 10, 11,  2,  2,  2,  2,  2,  2],
		[2, 2, 2, 2, 2, 2, 9, 10, 10, 10, 10, 10, 10, 10, 10,    10, 10, 10, 10, 10, 10, 8, 10, 11,  2,  2,  2,  2,  2,  2],
		[2, 2, 2, 2, 2, 2, 9, 10, 12, 14, 14, 14, 14, 14, 14,    14, 14, 14, 14, 14, 14, 8, 10, 11,  2,  2,  2,  2,  2,  2],
		[2, 2, 2, 2, 2, 2, 9, 10, 11,  2,  2,  2,  2,  2,  2,     2,  2,  2,  2,  2,  2, 9, 10, 11,  2,  2,  2,  2,  2,  2],
		[2, 2, 2, 2, 2, 2, 9, 10, 11,  2,  2,  2,  2,  2,  2,     2,  2,  2,  2,  2,  2, 9, 10, 11,  2,  2,  2,  2,  2,  2],
		[2, 2, 2, 2, 2, 2, 9, 10, 11,  2,  2,  2,  2,  2,  2,     2,  2,  2,  2,  2,  2, 9, 10, 11,  2,  2,  2,  2,  2,  2],
		[2, 2, 2, 2, 2, 2, 9, 10,  8,  6,  6,  6,  6,  6,  6,     6,  6,  6,  6,  6,  6, 8, 10, 11,  2,  2,  2,  2,  2,  2],
		[2, 2, 2, 2, 2, 2, 9, 10, 10, 10, 10, 10, 10, 10, 10,    10, 10, 10, 10, 10, 10, 8, 10, 11,  2,  2,  2,  2,  2,  2],
		[2, 2, 2, 2, 2, 2, 9, 10, 12, 14, 14, 14, 14, 14, 14,    14, 14, 14, 14, 14, 14, 8, 10, 11,  2,  2,  2,  2,  2,  2],
		[2, 2, 2, 2, 2, 2, 9, 10, 11,  2,  2,  2,  2,  2,  2,     2,  2,  2,  2,  2,  2, 9, 10, 11,  2,  2,  2,  2,  2,  2],
		[2, 2, 2, 2, 2, 2, 9, 10, 11,  2,  2,  2,  2,  2,  2,     2,  2,  2,  2,  2,  2, 9, 10, 11,  2,  2,  2,  2,  2,  2],
		[2, 2, 2, 2, 2, 2, 9, 10, 11,  2,  2,  2,  2,  2,  2,     2,  2,  2,  2,  2,  2, 9, 10, 11,  2,  2,  2,  2,  2,  2],

		[2, 2, 2, 2, 2, 2, 9, 10, 11,  2,  2,  2,  2,  2,  2,     2,  2,  2,  2,  2,  2, 9, 10, 11,  2,  2,  2,  2,  2,  2],
		[2, 2, 2, 2, 2, 2, 9, 10, 11,  2,  2,  2,  2,  2,  2,     2,  2,  2,  2,  2,  2, 9, 10, 11,  2,  2,  2,  2,  2,  2],
		[2, 2, 2, 2, 2, 2, 9, 10, 11,  2,  2,  2,  2,  2,  2,     2,  2,  2,  2,  2,  2, 9, 10, 11,  2,  2,  2,  2,  2,  2],
		[2, 2, 2, 2, 2, 2, 9, 10,  8,  6,  6,  6,  6,  6,  6,     6,  6,  6,  6,  6,  6, 8, 10, 11,  2,  2,  2,  2,  2,  2],
		[2, 2, 2, 2, 2, 2, 9, 10, 10, 10, 10, 10, 10, 10, 10,    10, 10, 10, 10, 10, 10, 8, 10, 11,  2,  2,  2,  2,  2,  2],
		[2, 2, 2, 2, 2, 2, 9, 10, 12, 14, 14, 14, 14, 14, 14,    14, 14, 14, 14, 14, 14, 8, 10, 11,  2,  2,  2,  2,  2,  2],
		[2, 2, 2, 2, 2, 2, 9, 10, 11,  2,  2,  2,  2,  2,  2,     2,  2,  2,  2,  2,  2, 9, 10, 11,  2,  2,  2,  2,  2,  2],
		[2, 2, 2, 2, 2, 2, 9, 10, 11,  2,  2,  2,  2,  2,  2,     2,  2,  2,  2,  2,  2, 9, 10, 11,  2,  2,  2,  2,  2,  2],
		[2, 2, 2, 2, 2, 2, 9, 10, 11,  2,  2,  2,  2,  2,  2,     2,  2,  2,  2,  2,  2, 9, 10, 11,  2,  2,  2,  2,  2,  2],
		[2, 2, 2, 2, 2, 2, 9, 10,  8,  6,  6,  6,  6,  6,  6,     6,  6,  6,  6,  6,  6, 8, 10, 11,  2,  2,  2,  2,  2,  2],
		[2, 2, 2, 2, 2, 2, 9, 10, 10, 10, 10, 10, 10, 10, 10,    10, 10, 10, 10, 10, 10, 8, 10, 11,  2,  2,  2,  2,  2,  2],
		[2, 2, 2, 2, 2, 2, 9, 10, 12, 14, 14, 14, 14, 14, 14,    14, 14, 14, 14, 14, 14, 8, 10, 11,  2,  2,  2,  2,  2,  2],
		[2, 2, 2, 2, 2, 2, 9, 10, 11,  2,  2,  2,  2,  2,  2,     2,  2,  2,  2,  2,  2, 9, 10, 11,  2,  2,  2,  2,  2,  2],
		[2, 2, 2, 2, 2, 2, 9, 10, 11,  2,  2,  2,  2,  2,  2,     2,  2,  2,  2,  2,  2, 9, 10, 11,  2,  2,  2,  2,  2,  2],
		[2, 2, 2, 2, 2, 2, 9, 10, 11,  2,  2,  2,  2,  2,  2,     2,  2,  2,  2,  2,  2, 9, 10, 11,  2,  2,  2,  2,  2,  2],

		[2, 2, 2, 2, 2, 2, 2,  2,  2,  2,  2,  2,  2,  2,  2,     2,  2,  2,  2,  2,  2, 2,  2,  2,  2,  2,  2,  2,  2,  2],
		[2, 2, 2, 2, 2, 2, 2,  2,  2,  2,  2,  2,  2,  2,  2,     2,  2,  2,  2,  2,  2, 2,  2,  2,  2,  2,  2,  2,  2,  2],
		[2, 2, 2, 2, 2, 2, 2,  2,  2,  2,  2,  2,  2,  2,  2,     2,  2,  2,  2,  2,  2, 2,  2,  2,  2,  2,  2,  2,  2,  2],
		[2, 2, 2, 2, 2, 2, 2,  2,  2,  2,  2,  2,  2,  2,  2,     2,  2,  2,  2,  2,  2, 2,  2,  2,  2,  2,  2,  2,  2,  2],
		[2, 2, 2, 2, 2, 2, 2,  2,  2,  2,  2,  2,  2,  2,  2,     2,  2,  2,  2,  2,  2, 2,  2,  2,  2,  2,  2,  2,  2,  2],
		[2, 2, 2, 2, 2, 2, 2,  2,  2,  2,  2,  2,  2,  2,  2,     2,  2,  2,  2,  2,  2, 2,  2,  2,  2,  2,  2,  2,  2,  2],
		[2, 2, 2, 2, 2, 2, 2,  2,  2,  2,  2,  2,  2,  2,  2,     2,  2,  2,  2,  2,  2, 2,  2,  2,  2,  2,  2,  2,  2,  2],
		[2, 2, 2, 2, 2, 2, 2,  2,  2,  2,  2,  2,  2,  2,  2,     2,  2,  2,  2,  2,  2, 2,  2,  2,  2,  2,  2,  2,  2,  2],
		[2, 2, 2, 2, 2, 2, 2,  2,  2,  2,  2,  2,  2,  2,  2,     2,  2,  2,  2,  2,  2, 2,  2,  2,  2,  2,  2,  2,  2,  2],
		[2, 2, 2, 2, 2, 2, 2,  2,  2,  2,  2,  2,  2,  2,  2,     2,  2,  2,  2,  2,  2, 2,  2,  2,  2,  2,  2,  2,  2,  2],
		[2, 2, 2, 2, 2, 2, 2,  2,  2,  2,  2,  2,  2,  2,  2,     2,  2,  2,  2,  2,  2, 2,  2,  2,  2,  2,  2,  2,  2,  2],
		[2, 2, 2, 2, 2, 2, 2,  2,  2,  2,  2,  2,  2,  2,  2,     2,  2,  2,  2,  2,  2, 2,  2,  2,  2,  2,  2,  2,  2,  2],
		[2, 2, 2, 2, 2, 2, 2,  2,  2,  2,  2,  2,  2,  2,  2,     2,  2,  2,  2,  2,  2, 2,  2,  2,  2,  2,  2,  2,  2,  2],
		[2, 2, 2, 2, 2, 2, 2,  2,  2,  2,  2,  2,  2,  2,  2,     2,  2,  2,  2,  2,  2, 2,  2,  2,  2,  2,  2,  2,  2,  2],
		[2, 2, 2, 2, 2, 2, 2,  2,  2,  2,  2,  2,  2,  2,  2,     2,  2,  2,  2,  2,  2, 2,  2,  2,  2,  2,  2,  2,  2,  2]
	]
}
